1111111111111
1001000000001
1000011111001
10P0110000C01
1001000000001
1000011111001
1111111111111