1111111111111
1001C00000001
1000011111001
10P011E000C01
1001000000001
1C00011111001
1111111111111