11111111111111111111111
10CCC0CCCCC1CCCCC0CCC01
10111011110101111011101
10111011110101111011101
10000000000P00000000001
10111010111111101011101
10CCC01CCCC1CCCC10CCC01
11111011110101111011111
11111010000000001011111
11111000111011100011111
11111010111E11101011111
11111010000000001011111
11111010111111101011111
1CCCC0CCCCC1CCCCC0CCCC1
10111011110101111011101
10001000000000000010001
1110101011111110101C111
1CCCC0100001000010CCCC1
1C1111111101011111111C1
1CCCCCCCCCCCCCCCCCCCCC1
11111111111111111111111